###########..###########
#......................#
#......................#
#......................#
#......................#
#....#.................#
#..###.................#
#..........#...........#
#..........##..........#
#......................#
####..............#....#
...#...........####.....
..................#.....
#.................#....#
#......................#
#..####........###.....#
#.....#........#.#.....#
#.....#........#.......#
#.....##...............#
#......................#
#.........###..........#
#......................#
##.....................#
###########..###########