########################
#.....##################
#..............#########
#.....########.#########
##############.#########
##############.#########
###########........#####
###########........#####
###########........#####
###########........#####
###########........#####
#..................#####
#..#####################
#..#####################
#..#####################
#..#####################
#..#####################
#..#####################
#..#####################
#......................#
#......................#
#......................#
#......................#
########################